################
################
################
################
#####S   rX#####
#######RR#######
#####    gX#####
#######GG#######
#####    bX#####
#######BB#######
#####      #####
#####  XX  #####
################
################
################
################
Sometimes there are obstacles to move around, or even objects to control