################
#   # # ## # # #
# ### # # ## # #
#  ## # # ##  ##
# ### # # ## # #
# #### ### # # #
################
#S# ##  ## ## ##
#X# # ## # ## ##
## ## ## # ## ##
## ## ## # ## ##
## ###  ###  ###
################
################
################
################
NO CHEATING!!!